111111111111111111
100E000000000C0001
100000000P00000001
1000C00000000C0001
111111111111111111