1111111
10000P1
10E0001
1111111