111111111111111111
10000000000010C001
100000011111100001
10000001P0000C00E1
111111111111111111