1111111111111111
1P01000010C10001
1001000011110001
1000000000000001
1111000000000001
1000000000000001
1000000C000000E1
1111111111111111