1111111
1001001
11110E1
1P00C01
1111111