1111111
1001001
11110E1
1P00001
1111111