1111111111111111111111111111111
1P000C0C0C0C0C0C0C00C0C00C00C01
1000000000000000000000000000001
1000011100111111001111001111101
10000E0010100001000010000010101
1C00000000000000000000000000001
1C00C00C00C00C00C00C00C00C00C01
1C00C00C00C00C00C00C00C00C00C01
1111111111111111111111111111111