111111111111111
1C00000000000C1
100100001110001
100101000C10001
101111P00110001
100001C01E00001
100001001110001
1000000000000C1
111111111111111