11111111111111
1E000000000001
10P11C000000C1
10000000000001
10000000000001
10011C00000001
11111100000001
11111100000001
10000000000001
10011C00000001
11111111111111