111111111111111
1C00001011000C1
100000101100001
100000100100001
101111101111101
100000111000001
1000001E1000001
1P0000000000001
111111111111111