11111111
1E000001
100P1001
100010C1
11111111