11111111111111111111
1C0000000000100000C1
100000000P0010111111
1E0000000000000000C1
11111111111111111111