11111111111111111
1P01000010C100011
11000000000000001
11101111111000001
10C001000010000E1
11111111111111111